NO ./NO_texture





EA                                ./EA_texure

11111111111111111111111111111111111
11N10000000000000000001111111111111
1010000000000000001111111
10000000000000000001111111
11110000000000000001111111
11110000000000000001111111
11110000000000000001111111
1111111111111111111111111111111111111111
11111111111111111111111111111111