NO ./NO_texture





EA                                ./EA_texure

     111111
    11111111111111111111111111111
111 1000N01111
111 1111111111111111111111
111 1111111111111111111111111111111111111
11
1
1
1
1
1
1
1
111111111111111111111111111111