NO ./NO_texture



F    220,100,0
C  240,89,10

EA                                ./EA_texure

11111111111111111111111111111111111
11110000000000000000001111111111111
1010000001111000001111111
1000000010001000001111111
111100010101010001111111
1111000000N00011000001111111
11110000000000000001111111
1111111111111111111111111111111111111111
11111111111111111111111111111111
