NO ./NO_texture





EA                                ./EA_texure

111 1
10011
11111
11111111111111111111111111111111111111111
