
F    20,20,20
C  20,10,5
EA            other-front-wall.xpm
WE                               back-wall.xpm
NO                              Pipe-wall.xpm
SO                              Pipe-wall.xpm


11111111111111111111111111111111111
111100000000000000000001
1010000001111000001111111
100000010001000001111111
111100000101010001111111
1111000000000010000001111111
11110000000000000001111111
1111111111111111111111111111111111111111
11111111111111111111111111111111
