NO ./NO_texture



F    80,80,80
C  100,150,240

EA                                ./EA_texure

11111111111111111111111111111111111
1111000000000000000000000000000111111
1010000000000011110000011111111101
1000000010101000000000011111111101
1111000000001010101000111111111101
1111000000N000000001100000111111001
11110000000000000000000011111111101
11000000010000000000000000000011101111
1100000010100000001000000000001110111
11000001111100000000000000000000001111
11000000000000000000000000000000111
11000000000000000011111110000111
1100000000000000001     1000111
1100011001000000000111110011111111111111
11000000010010010000000000000000000000001
11000000000000000000000000111111111111101
11011111111111111111111111111111      101
 101                                  101
 101                                  101
 101                                  101
 101                                  101
 101                                  101
 101                                  101
 101                                  101
 101                                  101
 1011111111111111111111111111111111111101
 1000000000000000000000000000000000000001
 1111111111111111111111111111111111111111
