NO ./NO_texture
EA                                ./EA_texure

F 220,100,0
C 225,30,0

1111111111111111
110010000000001
1100000000001111
101000001000011
111100000000011
11110000N000011
111111111111111