NO ./NO_texture





EA                                ./EA_texure
111
10 1
111
11111111111111111111111111111111111111111