
F    80,80,80
C  100,150,240
EA            metalsheets.xpm
WE                               metalsheets.xpm
NO                              metalsheets.xpm
SO                              metalsheets.xpm


11111111111111111111111111111111111
11110000000000000000001111111111111
1010000001111000001111111
1W00000010001000001111111
111100000101010001111111
1111000000000010000001111111
11110000000000000001111111
1111111111111111111111111111111111111111
11111111111111111111111111111111
