WE ./textures/back-wall.xpm
NO ./textures/side_wall.xpm
EA ./textures/other-front-wall.xpm
SO ./textures/Pipe-wall.xpm

C 20,20,20
F 20,10,5


11111111111111111111111111111111111111111111111111111111111111111111111111111
1E000000000000000000000000000000000000000000000000000000000000000000000000001
11111111111111111111111111111111111111111111111111111111111111111111111111111