WE ./textures/back-wall.xpm
EA ./textures/other-front-wall.xpm
SO ./textures/Pipe-wall.xpm
NO ./textures/side_wall.xpm

C  20,20,20
F 20,10


11111111111111111111111111111111111
11111111000000000000001111111111111
11111110000000000000000111111111111
11111100000000000000000011111111111
11111111001111011111111111111111111
10000000000000000000000000000000001
1E000000000000011111111111111111111
10000000000000011111111111111111111
10011000001111111111111111111111111
11111111111111111111111111111111111

